15
xxxxxxxxxxx
xRGRBCCBGRx
xRBBCGRGBGx
xGGRCBCCRBx
xBCGBRBGCGx
xCBBRRGCBBx
xxxxxxxxxxx