35
xxxxxxxxxxx
xBGCRBGCRBx
xGCRBGCRBGx
xCRBGCRBGCx
xRBGCRBGCRx
xBGCRBGCRBx
xxxxxxxxxxx