25
xxxxxxxxxxx
xGRRBBCCRBx
xCBCBRBRGBx
xRBGRGGRBCx
xRRGGCGCRBx
xBGCCGBBRCx
xxxxxxxxxxx